1100101111
0000000000
1111111111
1110001111
1100101111
0000000000
1111111111
1110001111
0000000000
1111111111