0010000100
1011010110
1000010010
0011011000
0110001101
0100100000
0101101010
0100101000
0000001011
1011000000